# # # # # # # # # # # # # # # # # # # #
# . . . . . . . . . # . . . ~ ~ . . * #
# # . . # . # . . . . . . . . # # . . #
# . . . # . # . # . . . # # ~ ~ # . . #
# . # . # . # # # # . . . . # . . . . #
# . # . . . . . . . . ~ ~ ~ . . # # . #
# . . . ~ ~ . . # . . # # . # . * * * #
# . # . ~ # . # # # . . . # . # * # . #
# ~ ~ ~ . # . # # # . # . . # . * * * #
# . # . # # # # . . . . . # # . . # . #
# . . # . . . # # # . # . # # # . . . #
# # . # . . . . . # . . # . . . . . . #
# ~ . . . # . . # . . # . . # ~ ~ . . #
# ~ ~ . . . . . . . . . # # . ~ . . . #
# . . . . # . . . . # # . # . . . . . #
# * * * . . . . . # . . . . # . . . . #
# * . . . . # . . . . # . . # # # . . #
# . # . . . . # . . # . . . . . ~ ~ ~ #
# . . # . . . # . # . # # * * * ~ ~ . #
# # # # # # # # # # # # # # # # # # # #
